NO ./sprites/north.xpm
SO ./sprites/south.xpm
WE ./sprites/west.xpm
EA ./sprites/east.xpm
C 0,10,10
F let 10,10,10

111111111111111
100000000000001
100000000000001
100000000000001
1000000N0000001
100000000000001
100000000000001
100000000000001
111111111111111