          SO ./sprites/nature_so.xpm
      NO       ./sprites/tree_no.xpm
             WE ./sprites/tree_we.xpm
       EA ./sprites/tree_ea.xpm

C 10,214,255
F 154,205,50

111111111
1000000011111
10000000000001
100000000000001
1010000011111001    111
1001000010000001    11111111111111111111111111111111111111111111111111111111111111111111111111111111111111111111111111111111111111111111111111111
10N0000010000111    111
1111111110001111
     1111111  1 
1111100000011101
110000011000101
1111110000011111
11111111111111